25
OOO0OOOOO00OOOOOO0000OOOO
0OOOO00OOOOOO0OOOOOOOOO0O
0O0O00O0O000OO0000000000O
0O0OO0O0OO0OO0OO00O0O0O0O
0OO0OOO0O0O0O0OOO0OOOOO0O
OO0OOOO0000OO0OOO00O0O00O
0O000O0O0O00O0OOO0OOO000O
0OOO000O0OOOO0OOO0O0OOO0O
000OOOOO000O0O0OO0OO0OO0O
00OOO00O0OOOO000O0O000O0O
OOO0OOO0OO0OOOO0OOO0OO00O
0OOO0000O0OO00O0O0OOOOO0O
OO000OOO0O0OO0OOO000O0O0O
0OOO00O0OOOOO0O00OO0O0O0O
00O0OOO0O0OOO0O0O0OOOOO0O
OO0O00O0O0OOO0OOOOOO00O0O
0O0OOO0OOOO0000O00O00OO0O
0OOO000O0OOOO0OOO0OOO000O
000OOOOO0O00O0OOO0OOOOO0O
00OOO00O00OO00O0O0O00000O
OOO00O0O0OOOO0OOO0OOO000O
0OOOOOOO000O0O0OO0OOOOO0O
OO0000OO0O0OO000OO000OOOO
OO000OO0OO0OO0OOOOO000000
OOOOOO0O0OO00000OOOOOOOOO
