10
OOO0OOO0OO
O0OOOO0OOO
OOO00OOO0O
OO0OO0O0OO
O0O0OOO0O0
OO0OOOO0O0
0O0OOO0OOO
0O0O000O0O
OO0OOOO000
OO0OO0OOOO
